0 1 2 2 2 2 2 2 2 2 2 2 2 2 2 2 2 2 2 2 2 2 2 0 0 0 0 0 0 0 0 0 0 0 0 0 0 0 0 0 0 0 0 0 0 0 0 0 0 0 
20 21 22 22 22 22 22 22 22 22 22 22 22 22 22 22 22 22 22 22 22 22 22 23 0 0 0 0 0 0 0 0 0 0 0 0 0 0 0 0 0 0 0 0 0 0 0 0 0 0 
40 41 272 270 154 195 272 154 271 271 42 154 272 161 181 4 42 42 42 42 42 42 42 196 197 197 197 197 197 197 197 197 197 197 197 197 197 197 197 197 197 197 197 197 3 0 0 0 0 0 
40 41 42 42 42 289 181 42 181 42 272 42 42 141 154 161 42 42 4 42 42 42 42 42 217 217 217 217 217 217 217 217 217 217 217 217 217 217 217 217 217 217 217 217 23 24 0 0 0 0 
40 41 181 42 274 42 181 270 270 42 271 42 42 141 141 161 42 42 42 42 16 42 9 42 42 42 42 42 17 42 42 18 42 42 42 42 17 42 42 42 42 42 18 42 43 44 0 0 0 0 
40 41 271 42 271 272 42 289 42 42 42 154 42 4 141 161 42 42 18 42 42 42 42 42 42 42 42 42 42 42 42 16 42 4 42 16 42 42 9 42 42 42 42 42 43 44 0 0 0 0 
40 41 195 42 289 42 272 195 42 4 42 42 42 141 141 161 161 42 42 42 4 42 42 42 42 4 42 16 42 42 42 42 17 42 42 42 42 42 42 42 42 16 42 42 43 44 0 0 0 0 
40 41 42 275 42 271 42 42 293 181 289 270 42 141 161 195 161 42 4 42 42 42 42 42 42 42 17 42 18 42 4 42 42 42 42 42 42 42 42 42 42 42 42 17 43 44 0 0 0 0 
40 41 289 42 195 42 42 291 42 42 141 141 141 9 141 161 42 42 4 42 42 42 18 42 42 42 42 42 42 42 42 42 42 18 42 9 42 42 42 42 42 9 42 42 43 44 0 0 0 0 
60 61 62 62 62 62 62 52 53 271 141 271 141 141 141 161 42 42 42 42 42 16 42 42 4 42 42 42 42 42 161 17 42 16 42 42 42 42 18 42 42 42 42 42 43 44 0 0 0 0 
0 70 71 71 71 71 71 72 73 161 141 141 4 141 141 161 42 42 4 42 18 42 42 42 42 42 42 9 42 42 161 161 4 42 18 42 42 42 42 16 42 42 42 42 43 44 0 0 0 0 
0 90 91 91 91 91 91 92 93 271 141 141 141 141 141 161 42 17 42 42 42 42 42 42 42 42 42 17 42 42 9 161 42 42 42 42 42 42 42 42 17 42 42 42 43 44 0 0 0 0 
0 0 111 111 111 111 111 112 113 161 161 161 161 161 161 42 16 18 42 17 42 42 42 42 4 42 42 42 42 42 161 161 42 42 54 55 55 55 55 55 62 142 55 55 63 64 0 0 0 0 
0 0 0 0 0 0 0 60 61 62 62 62 62 62 62 62 62 62 62 62 62 62 62 62 62 62 62 62 62 62 53 54 55 55 63 82 82 82 82 82 82 162 82 82 83 84 0 0 0 0 
0 0 0 0 0 0 0 80 81 82 82 82 82 82 82 82 71 71 71 71 71 71 71 71 71 71 71 71 71 72 73 94 75 82 83 201 202 202 202 202 202 182 202 202 203 104 0 0 0 0 
0 0 0 0 0 0 0 80 90 91 91 91 91 91 91 91 91 91 91 91 91 91 91 91 91 91 91 91 91 92 93 94 201 202 203 221 222 222 222 222 222 222 222 222 43 44 0 0 0 0 
0 0 0 0 0 0 0 0 110 111 111 111 111 111 111 111 111 111 111 111 111 111 111 111 111 111 111 111 111 112 113 114 117 222 223 42 9 42 42 42 42 42 42 57 43 44 0 0 0 0 
0 0 0 0 0 0 0 0 0 0 0 0 0 0 0 0 0 0 0 0 0 0 0 0 0 0 0 0 0 40 41 114 97 183 195 42 42 42 56 181 42 58 42 42 43 44 0 0 0 0 
0 0 0 0 0 0 0 0 0 0 0 0 0 0 0 0 0 0 0 0 0 0 0 0 0 0 0 0 0 40 41 114 97 42 18 59 19 42 17 42 42 9 42 42 43 44 0 0 0 0 
0 0 0 0 0 0 0 0 0 0 0 0 0 0 0 0 0 0 0 0 0 0 0 0 0 0 0 0 0 40 41 114 97 56 42 19 59 42 42 42 42 42 42 17 43 44 0 0 0 0 
0 0 0 0 0 0 0 0 0 0 0 0 0 0 0 0 0 0 0 0 0 0 0 0 0 0 0 0 0 40 41 114 97 16 183 42 42 42 58 42 18 42 42 42 43 44 0 0 0 0 
0 0 0 0 0 0 0 0 0 0 0 0 0 0 0 0 0 0 0 0 0 0 0 0 0 0 0 0 0 40 41 114 117 42 42 57 16 42 42 42 56 42 42 224 43 44 0 0 0 0 
0 0 0 0 0 0 0 0 0 0 0 0 0 0 0 0 0 0 0 0 0 0 0 0 0 0 0 0 0 40 41 114 117 9 42 19 42 145 181 42 42 42 42 19 43 44 0 0 0 0 
0 0 0 0 0 0 0 0 0 0 0 0 0 0 0 0 0 0 0 0 0 0 0 0 0 0 0 0 0 40 41 116 117 181 56 42 42 56 42 16 42 42 9 59 43 44 0 0 0 0 
0 0 0 0 0 0 0 0 0 0 0 0 0 0 0 0 0 0 0 0 0 0 0 0 0 0 0 0 0 40 41 116 117 42 42 59 42 9 42 42 57 19 42 42 43 44 0 0 0 0 
0 0 0 0 0 0 0 0 0 0 0 0 0 0 0 0 0 0 0 0 0 0 0 0 0 0 0 0 0 40 41 136 86 86 86 86 86 86 86 86 86 86 86 42 43 44 0 0 0 0 
0 0 0 0 0 0 0 0 0 0 0 0 0 0 0 0 0 0 0 0 0 0 0 0 0 0 0 0 0 40 41 42 217 217 217 217 22 22 22 22 22 22 68 49 43 44 0 0 0 0 
0 0 0 0 0 0 0 0 0 0 0 0 0 0 0 0 0 0 0 0 0 0 0 0 0 0 0 0 0 40 41 54 55 51 50 51 51 52 53 42 42 4 43 69 43 44 0 0 0 0 
0 0 0 0 0 0 0 0 0 0 0 0 0 0 0 0 0 0 0 0 0 0 0 0 0 0 0 0 0 40 41 116 75 131 70 71 71 72 73 145 195 145 43 144 43 44 0 0 0 0 
0 0 0 0 0 0 0 0 0 0 0 0 0 0 0 0 0 0 0 0 0 0 0 0 0 0 0 0 0 40 41 116 132 131 132 131 131 92 93 145 145 195 43 144 43 44 0 0 0 0 
0 0 0 0 0 0 0 0 0 0 0 0 0 0 0 0 0 0 0 0 0 0 0 0 0 0 0 0 0 40 41 136 137 151 152 151 151 160 61 62 142 62 63 164 43 44 0 0 0 0 
0 0 0 0 0 0 0 0 0 0 0 0 0 0 0 0 0 0 0 0 0 0 0 0 0 0 0 0 0 40 41 42 116 69 42 163 18 180 81 82 162 82 83 184 43 44 0 0 0 0 
0 0 0 0 0 0 0 0 0 0 0 0 0 0 0 0 0 0 0 0 0 0 0 0 0 0 0 0 0 40 41 54 63 69 17 58 42 125 126 127 182 127 128 204 43 44 0 0 0 0 
0 0 0 0 0 0 0 0 0 0 0 0 0 0 0 0 0 0 0 0 0 0 0 0 0 0 0 0 0 40 41 116 75 89 59 16 59 17 56 42 42 42 58 42 43 44 0 0 0 0 
0 0 0 0 0 0 0 0 0 0 0 0 0 0 0 0 0 0 0 0 0 0 0 0 0 0 0 0 0 40 41 116 130 129 19 56 42 42 181 18 42 145 19 19 43 44 0 0 0 0 
0 0 0 0 0 0 0 1 198 198 198 198 198 198 198 198 198 198 198 198 198 198 198 198 198 198 198 198 198 198 199 136 137 86 86 86 86 86 86 86 62 62 62 62 63 44 0 0 0 0 
0 0 0 0 0 0 20 21 218 218 218 218 218 218 218 218 218 218 218 218 218 218 218 218 218 218 218 218 218 218 42 145 22 22 22 22 22 22 22 23 75 83 83 83 83 0 0 0 0 0 
0 0 0 0 0 0 40 41 42 155 42 42 161 161 161 161 42 42 42 42 161 161 161 161 42 42 161 42 163 42 163 42 42 42 42 42 161 42 134 43 95 102 102 102 103 0 0 0 0 0 
0 0 0 0 0 0 40 41 42 42 161 161 154 42 154 161 161 161 161 161 161 42 42 134 42 161 161 42 42 134 42 154 42 163 163 154 134 161 42 43 115 122 122 122 123 0 0 0 0 0 
0 0 0 0 0 0 40 41 42 42 161 42 134 195 163 163 143 163 42 195 42 42 42 42 42 42 42 161 161 42 163 134 42 42 163 154 42 161 42 43 44 0 0 0 0 0 0 0 0 0 
0 0 0 0 0 0 40 41 42 161 143 163 163 143 42 42 42 42 163 42 42 154 42 163 42 154 42 42 161 161 42 42 42 134 42 42 42 161 134 43 44 0 0 0 0 0 0 0 0 0 
0 0 0 0 0 0 40 41 42 161 161 154 143 163 163 42 154 42 161 143 42 42 42 42 42 42 42 42 42 161 134 42 42 42 42 134 161 161 42 43 44 0 0 0 0 0 0 0 0 0 
0 0 0 0 0 0 40 41 161 161 195 163 163 134 42 163 161 161 163 163 163 42 134 42 163 42 134 42 42 42 154 42 154 42 163 42 42 42 161 43 44 0 0 0 0 0 0 0 0 0 
0 0 0 0 0 0 40 41 42 161 161 161 42 161 161 161 42 154 42 42 42 42 42 42 141 143 42 154 42 163 143 42 163 163 163 161 154 161 134 43 44 0 0 0 0 0 0 0 0 0 
0 0 0 0 0 0 40 41 195 134 42 42 42 42 42 42 42 42 42 42 161 42 154 42 42 141 163 42 42 163 42 42 42 42 134 42 161 42 42 43 44 0 0 0 0 0 0 0 0 0 
0 0 0 0 0 0 40 41 42 42 54 50 55 55 55 55 55 55 55 55 55 55 62 51 51 51 51 51 51 51 51 51 51 51 51 51 51 50 50 63 64 0 0 0 0 0 0 0 0 0 
0 0 0 0 0 0 40 41 42 42 74 75 70 70 70 70 70 70 70 70 70 70 71 71 71 71 71 71 71 71 71 71 71 71 71 71 71 81 82 83 84 0 0 0 0 0 0 0 0 0 
0 0 0 0 0 0 40 41 42 42 94 95 90 90 90 90 90 90 90 90 90 90 91 91 91 91 91 91 91 91 91 91 91 91 91 91 91 81 102 103 104 0 0 0 0 0 0 0 0 0 
0 0 0 0 0 0 80 61 62 62 63 115 110 110 110 110 110 110 110 110 110 110 111 111 111 111 111 111 111 111 111 111 111 111 111 111 111 121 122 123 0 0 0 0 0 0 0 0 0 0 
0 0 0 0 0 0 100 101 102 102 103 0 0 0 0 0 0 0 0 0 0 0 0 0 0 0 0 0 0 0 0 0 0 0 0 0 0 0 0 0 0 0 0 0 0 0 0 0 0 0 
