42 42 175 42 42 42 181 42 43 24 0 0 0 0 0 0 0 0 0 0 0 0 0 0 0 0 0 0 0 0 0 0 0 0 0 0 0 0 0 0 0 0 0 0 0 0 0 0 0 0 
50 51 50 50 50 52 53 42 43 24 0 0 0 0 0 0 0 0 0 0 0 0 0 0 0 0 0 0 0 0 0 0 0 0 0 0 0 0 0 0 0 0 0 0 0 0 0 0 0 0 
70 71 70 70 70 72 73 9 43 24 0 0 0 0 0 0 0 0 0 0 0 0 0 0 0 0 0 0 0 0 0 0 0 0 0 0 0 0 0 0 0 0 0 0 0 0 0 0 0 0 
90 91 90 90 90 92 93 293 43 24 0 0 0 0 0 0 0 0 0 0 0 0 0 0 0 0 0 0 0 0 0 0 0 0 0 0 0 0 0 0 0 0 0 0 0 0 0 0 0 0 
0 111 0 0 0 112 61 62 63 84 0 0 0 0 0 0 0 0 0 0 0 0 0 0 0 0 0 0 0 0 0 0 0 0 0 0 0 0 0 0 0 0 0 0 0 0 0 0 0 0 
0 0 0 0 0 0 81 82 83 0 0 0 0 0 0 0 0 0 0 0 0 0 0 0 0 0 0 0 0 0 0 0 0 0 0 0 0 0 0 0 0 0 0 0 0 0 0 0 0 0 
0 0 0 0 0 0 101 102 103 0 0 0 0 0 0 0 0 0 0 0 0 0 0 0 0 0 0 0 0 0 0 0 0 0 0 0 0 0 0 0 0 0 0 0 0 0 0 0 0 0 
0 0 0 0 0 0 121 122 123 0 0 0 0 0 0 0 0 0 0 0 0 0 0 0 0 0 0 0 0 0 0 0 0 0 0 0 0 0 0 0 0 0 0 0 0 0 0 0 0 0 
0 0 0 1 11 11 11 11 11 11 11 11 0 2 2 11 10 2 2 2 2 2 13 11 2 10 2 2 2 2 2 3 0 0 0 0 0 0 0 0 0 0 0 0 0 0 0 0 0 0 
0 0 20 21 31 31 31 31 31 31 31 31 30 22 22 31 30 22 22 22 22 22 33 31 22 32 22 22 22 22 22 34 24 0 0 0 0 0 0 0 0 0 0 0 0 0 0 0 0 0 
0 0 40 41 145 161 161 161 161 161 42 42 269 175 249 9 252 42 252 42 252 42 154 42 42 42 254 161 161 161 161 43 44 0 0 0 0 0 0 0 0 0 0 0 0 0 0 0 0 0 
0 0 40 41 161 143 143 143 143 143 161 292 42 42 42 145 42 42 249 42 42 42 254 42 249 42 161 249 141 154 161 43 44 0 0 0 0 0 0 0 0 0 0 0 0 0 0 0 0 0 
0 0 178 179 161 143 143 143 155 271 161 42 173 42 252 161 252 145 161 42 275 145 145 42 271 42 161 141 289 141 161 43 44 0 0 0 0 0 0 0 0 0 0 0 0 0 0 0 0 0 
11 10 198 199 161 143 143 143 143 143 161 42 42 42 86 86 86 86 86 86 86 86 86 291 42 249 161 255 141 141 161 43 44 0 0 0 0 0 0 11 11 10 11 10 2 2 2 2 2 2 
31 30 22 4 145 161 161 161 161 161 42 42 161 106 7 7 7 7 7 7 7 7 108 42 291 42 42 289 161 161 154 196 197 12 13 12 13 10 21 31 31 32 31 32 22 22 22 22 22 22 
42 42 4 161 37 19 18 18 18 36 9 161 45 26 27 16 17 18 27 27 27 27 28 9 42 42 42 42 254 273 42 154 217 31 31 32 31 30 42 42 42 269 270 9 9 251 42 42 42 42 
50 51 52 53 77 38 38 38 38 76 42 42 85 46 67 47 233 234 235 233 234 233 48 69 143 42 291 42 173 42 293 54 55 51 50 51 52 52 53 4 42 253 42 291 42 42 254 42 4 42 
70 71 72 73 240 241 241 241 241 242 42 161 105 81 87 83 70 82 82 70 82 70 83 109 161 161 42 161 249 42 42 43 75 71 70 70 70 72 73 42 42 42 42 271 291 42 253 42 291 42 
90 91 92 93 260 261 243 267 267 246 242 42 125 126 107 128 127 127 127 127 127 127 128 129 42 249 161 289 42 42 251 43 95 91 90 90 90 92 93 42 253 42 42 42 269 42 42 42 42 291 
110 111 112 113 260 261 263 145 145 266 265 42 4 146 147 148 146 147 147 147 147 147 148 163 161 42 4 42 249 42 42 43 115 111 110 110 110 112 41 42 42 42 270 181 42 270 291 42 270 42 
0 0 40 41 260 261 263 145 145 266 265 42 145 143 42 42 181 42 42 42 42 42 251 42 42 251 42 42 42 174 289 43 44 0 0 0 0 40 41 42 254 181 42 269 42 252 42 272 42 42 
0 0 40 41 260 261 283 247 247 284 265 42 54 55 50 51 51 55 51 51 55 51 51 50 51 51 51 51 51 51 51 63 64 0 0 0 0 40 41 42 4 270 42 290 181 42 272 274 4 42 
0 0 40 41 260 261 261 261 243 267 42 42 74 75 70 71 71 70 71 71 70 71 71 70 71 71 71 71 71 71 71 83 84 0 0 0 0 40 41 4 42 42 250 42 292 270 42 42 272 42 
0 0 40 41 280 281 281 281 282 145 161 42 43 95 90 91 91 90 91 91 91 91 91 90 91 91 91 91 91 91 91 103 104 0 0 0 0 40 41 42 42 42 42 42 42 42 42 42 42 42 
0 0 40 41 42 42 42 42 42 42 42 42 43 115 0 111 111 0 111 111 111 111 111 0 111 111 111 111 111 111 111 123 0 0 0 0 0 40 41 42 269 42 42 42 42 251 42 42 42 42 
0 0 40 41 42 42 42 42 42 42 42 42 43 44 0 0 0 0 0 0 0 0 0 0 0 0 0 0 0 0 0 0 0 0 0 0 0 40 41 42 42 42 42 252 42 42 291 42 42 42 
0 0 40 41 42 42 4 42 42 42 42 42 43 44 0 0 0 0 0 0 0 0 0 0 0 0 0 0 0 0 0 0 0 0 0 0 0 40 41 42 42 42 293 42 42 42 42 42 42 42 
0 0 40 41 54 55 52 53 54 55 51 50 63 24 0 0 0 0 0 0 0 0 0 0 0 0 0 0 0 0 0 0 0 0 0 0 0 60 61 62 62 62 62 62 62 62 62 62 62 62 
0 0 40 41 176 72 72 73 43 75 71 70 83 84 0 0 0 0 0 0 0 0 0 0 0 0 0 0 0 0 0 0 0 0 0 0 0 80 81 82 82 82 82 82 82 82 82 82 82 82 
0 0 40 41 116 95 92 93 43 95 91 90 91 0 0 0 0 0 0 0 0 0 0 0 0 0 0 0 0 0 0 0 0 0 0 0 0 100 101 102 102 102 102 102 102 102 102 102 102 102 
0 0 40 41 116 157 158 179 43 115 111 110 111 0 0 0 0 0 0 0 0 0 0 0 0 0 0 0 0 0 0 0 0 0 0 0 0 0 121 122 122 122 122 122 122 122 122 122 122 122 
0 0 21 42 116 177 178 159 42 23 0 0 0 0 0 0 0 0 0 0 0 0 0 0 0 0 0 0 0 0 0 0 0 0 0 0 0 0 0 0 0 0 0 0 0 0 0 0 0 0 
0 40 41 42 136 5 198 199 42 43 44 0 0 0 0 0 1 2 3 0 0 0 0 0 0 0 0 0 0 0 0 0 0 0 0 0 0 0 0 0 0 0 0 0 0 0 0 0 0 0 
0 0 61 53 42 217 218 42 54 63 64 0 0 0 0 0 21 22 23 0 0 0 0 0 0 0 0 0 0 0 0 0 0 0 0 0 0 0 0 0 0 0 0 0 0 0 0 0 0 0 
0 0 72 73 42 42 42 42 74 75 84 0 0 0 0 20 41 134 43 44 0 0 0 0 0 0 0 0 0 0 0 0 0 0 0 0 0 0 0 0 0 0 0 0 0 0 0 0 0 0 
0 0 92 61 52 53 54 55 63 95 0 0 0 0 0 40 61 62 63 64 0 0 0 0 0 0 0 0 0 0 0 0 0 0 0 0 0 0 0 0 0 0 0 0 0 0 0 0 0 0 
0 0 112 81 72 73 43 75 83 115 0 0 0 0 0 80 81 82 83 84 0 0 0 0 0 0 0 0 0 0 0 0 0 0 0 0 0 0 0 0 0 0 0 0 0 0 0 0 0 0 
0 0 100 101 92 41 94 95 103 104 0 0 0 0 0 100 101 102 103 104 0 0 0 0 0 0 0 0 0 0 0 0 0 0 0 0 0 0 0 0 0 0 0 0 0 0 0 0 0 0 
0 0 0 121 112 41 43 123 123 0 0 0 0 0 0 0 121 122 123 0 0 0 0 0 0 0 0 0 0 0 0 0 0 0 0 0 0 0 0 0 0 0 0 0 0 0 0 0 0 0 
0 0 0 0 40 41 43 44 0 0 0 0 0 0 0 0 0 0 0 0 0 0 0 0 0 0 0 0 0 0 0 0 0 0 0 0 0 0 0 0 0 0 0 0 0 0 0 0 0 0 
0 0 0 0 40 41 43 44 0 0 0 0 0 0 0 0 0 0 0 0 0 0 0 0 0 0 0 0 0 0 0 0 0 0 0 0 0 0 0 0 0 0 0 0 0 0 0 0 0 0 
0 0 0 0 40 41 43 44 0 0 0 0 0 0 0 0 0 0 0 0 0 0 0 0 0 0 0 0 0 0 0 0 0 0 0 0 0 0 0 0 0 0 0 0 0 0 0 0 0 0 
0 0 0 2 198 199 196 197 3 0 0 0 0 0 0 0 0 0 0 0 0 0 0 0 0 0 0 0 0 0 0 0 0 0 0 0 0 0 0 0 0 0 0 0 0 0 0 0 0 0 
0 0 21 22 217 174 175 217 23 0 0 0 0 0 0 0 0 0 0 0 0 0 0 0 0 0 0 0 0 0 0 0 0 0 0 0 0 0 0 0 0 0 0 0 0 0 0 0 0 0 
0 60 61 62 52 53 161 42 63 0 0 0 0 0 0 0 0 0 0 0 0 0 0 0 0 0 0 2 3 0 0 0 0 0 0 0 0 0 0 0 0 0 0 0 0 0 0 0 0 0 
0 80 81 82 72 41 42 63 83 0 0 0 0 0 0 0 0 0 0 0 0 0 0 0 0 0 6 7 8 24 0 0 0 0 0 0 0 0 0 0 0 0 0 0 0 0 0 0 0 0 
0 100 101 102 92 41 43 83 102 0 21 23 0 0 0 0 0 0 0 0 0 0 0 0 0 40 26 27 28 84 0 0 0 0 0 0 0 0 0 0 0 0 0 0 0 0 0 0 0 0 
0 0 121 122 112 41 196 197 197 198 199 196 197 11 11 197 0 0 0 0 0 0 0 0 0 60 46 47 48 84 0 0 0 0 0 0 0 0 0 0 0 0 0 0 0 0 0 0 0 0 
0 0 0 0 40 41 173 217 218 218 42 42 42 32 31 42 31 31 32 31 30 31 33 33 34 80 81 82 83 84 0 0 0 0 0 0 0 0 0 0 0 0 0 0 0 0 0 0 0 0 
0 0 0 0 60 61 62 62 62 62 52 50 62 62 62 62 62 52 53 42 42 42 42 42 43 44 101 102 103 0 0 0 0 0 0 0 0 0 0 0 0 0 0 0 0 0 0 0 0 0 
