0 1 2 2 2 2 2 2 2 2 2 2 2 2 2 2 2 2 2 2 2 2 2 0 0 0 0 0 0 0 0 0 0 0 0 0 0 0 0 0 0 0 0 0 0 0 0 0 0 0 
20 21 22 22 22 22 22 22 22 22 22 22 22 22 22 22 22 22 22 22 22 22 22 23 0 0 0 0 0 0 0 0 0 0 0 0 0 0 0 0 0 0 0 0 0 0 0 0 0 0 
40 41 272 270 155 42 272 155 253 253 42 154 272 163 181 4 42 42 42 42 42 42 42 196 197 197 197 197 197 197 197 197 197 197 197 197 197 197 197 197 197 197 197 197 3 0 0 0 0 0 
40 41 42 42 42 289 181 42 181 42 272 42 42 163 155 181 42 42 4 42 42 42 42 42 217 217 217 217 217 217 217 217 217 217 217 217 217 217 217 217 217 217 217 217 23 24 0 0 0 0 
40 41 181 42 252 42 181 270 270 42 253 42 42 163 163 181 42 42 42 42 42 42 9 42 42 42 42 42 42 42 42 42 42 42 42 42 42 42 42 42 42 42 42 42 43 44 0 0 0 0 
40 41 251 42 250 272 42 289 42 42 42 154 42 4 163 181 42 42 42 42 42 42 42 42 42 42 42 42 42 42 42 42 42 4 42 42 42 42 9 42 42 42 42 42 43 44 0 0 0 0 
40 41 155 42 289 42 272 155 42 4 42 42 42 163 163 181 181 42 42 42 4 42 42 42 42 4 42 42 42 42 42 42 42 42 42 42 42 42 42 42 42 42 42 42 43 44 0 0 0 0 
40 41 42 275 42 251 42 42 293 181 289 270 42 163 161 155 181 42 4 42 42 42 42 42 42 42 42 42 42 42 4 42 42 42 42 42 42 42 42 42 42 42 42 42 43 44 0 0 0 0 
40 41 289 42 155 42 42 291 42 42 163 163 163 9 163 161 42 42 4 42 42 42 42 42 42 42 42 42 42 42 42 42 42 42 42 9 42 42 42 42 42 9 42 42 43 44 0 0 0 0 
60 61 62 62 62 62 62 52 53 251 163 271 163 163 163 161 42 42 42 42 42 42 42 42 4 42 42 42 42 42 161 42 42 42 42 42 42 42 42 42 42 42 42 42 43 44 0 0 0 0 
0 70 71 71 71 71 71 72 73 163 163 163 4 163 163 161 42 42 4 42 42 42 42 42 42 42 42 9 42 42 161 161 4 42 42 42 42 42 42 42 42 42 42 42 43 44 0 0 0 0 
0 90 91 91 91 91 91 92 93 271 163 163 163 163 163 161 42 42 42 42 42 42 42 42 42 42 42 42 42 42 9 161 42 42 42 42 42 42 42 42 42 42 42 42 43 44 0 0 0 0 
0 0 111 111 111 111 111 112 113 161 161 161 161 161 161 42 42 42 42 42 42 42 42 42 4 42 42 42 42 42 161 161 42 42 54 55 55 55 55 55 62 142 55 55 63 64 0 0 0 0 
0 0 0 0 0 0 0 60 61 62 62 62 62 62 62 62 62 62 62 62 62 62 62 62 62 62 62 62 62 62 53 54 55 55 63 82 82 82 82 82 82 162 82 82 83 84 0 0 0 0 
0 0 0 0 0 0 0 80 81 82 82 82 82 82 82 82 71 71 71 71 71 71 71 71 71 71 71 71 71 72 73 94 75 82 83 201 202 202 202 202 202 182 202 202 203 104 0 0 0 0 
0 0 0 0 0 0 0 80 90 91 91 91 91 91 91 91 91 91 91 91 91 91 91 91 91 91 91 91 91 92 93 94 201 202 203 221 222 222 222 222 222 222 222 222 43 44 0 0 0 0 
0 0 0 0 0 0 0 0 110 111 111 111 111 111 111 111 111 111 111 111 111 111 111 111 111 111 111 111 111 112 113 114 117 222 223 145 9 145 145 145 145 145 145 134 43 44 0 0 0 0 
0 0 0 0 0 0 0 0 0 0 0 0 0 0 0 0 0 0 0 0 0 0 0 0 0 0 0 0 0 40 41 114 97 145 145 145 145 145 134 145 145 134 145 145 43 44 0 0 0 0 
0 0 0 0 0 0 0 0 0 0 0 0 0 0 0 0 0 0 0 0 0 0 0 0 0 0 0 0 0 40 41 114 97 145 145 154 145 145 145 145 145 9 145 145 43 44 0 0 0 0 
0 0 0 0 0 0 0 0 0 0 0 0 0 0 0 0 0 0 0 0 0 0 0 0 0 0 0 0 0 40 41 114 97 134 145 145 134 145 145 145 145 145 145 145 43 44 0 0 0 0 
0 0 0 0 0 0 0 0 0 0 0 0 0 0 0 0 0 0 0 0 0 0 0 0 0 0 0 0 0 40 41 114 97 145 145 145 145 145 154 145 145 145 145 145 43 44 0 0 0 0 
0 0 0 0 0 0 0 0 0 0 0 0 0 0 0 0 0 0 0 0 0 0 0 0 0 0 0 0 0 40 41 114 117 145 145 154 145 145 145 145 134 145 145 145 43 44 0 0 0 0 
0 0 0 0 0 0 0 0 0 0 0 0 0 0 0 0 0 0 0 0 0 0 0 0 0 0 0 0 0 40 41 114 117 9 145 145 145 145 145 145 145 145 145 145 43 44 0 0 0 0 
0 0 0 0 0 0 0 0 0 0 0 0 0 0 0 0 0 0 0 0 0 0 0 0 0 0 0 0 0 40 41 116 117 145 134 145 145 134 145 145 145 145 9 134 43 44 0 0 0 0 
0 0 0 0 0 0 0 0 0 0 0 0 0 0 0 0 0 0 0 0 0 0 0 0 0 0 0 0 0 40 41 116 117 145 145 134 145 9 145 145 154 145 145 145 43 44 0 0 0 0 
0 0 0 0 0 0 0 0 0 0 0 0 0 0 0 0 0 0 0 0 0 0 0 0 0 0 0 0 0 40 41 136 86 86 86 86 86 86 86 86 86 86 86 145 43 44 0 0 0 0 
0 0 0 0 0 0 0 0 0 0 0 0 0 0 0 0 0 0 0 0 0 0 0 0 0 0 0 0 0 40 41 145 217 217 217 217 22 22 22 22 22 22 68 49 43 44 0 0 0 0 
0 0 0 0 0 0 0 0 0 0 0 0 0 0 0 0 0 0 0 0 0 0 0 0 0 0 0 0 0 40 41 54 55 51 50 51 51 52 53 42 42 145 43 69 43 44 0 0 0 0 
0 0 0 0 0 0 0 0 0 0 0 0 0 0 0 0 0 0 0 0 0 0 0 0 0 0 0 0 0 40 41 116 75 131 70 71 71 72 73 145 145 145 43 144 43 44 0 0 0 0 
0 0 0 0 0 0 0 0 0 0 0 0 0 0 0 0 0 0 0 0 0 0 0 0 0 0 0 0 0 40 41 116 132 131 132 131 131 92 93 145 145 145 43 144 43 44 0 0 0 0 
0 0 0 0 0 0 0 0 0 0 0 0 0 0 0 0 0 0 0 0 0 0 0 0 0 0 0 0 0 40 41 136 137 151 152 151 151 160 61 62 142 62 63 164 43 44 0 0 0 0 
0 0 0 0 0 0 0 0 0 0 0 0 0 0 0 0 0 0 0 0 0 0 0 0 0 0 0 0 0 40 41 42 116 69 145 145 145 180 81 82 162 82 83 184 43 44 0 0 0 0 
0 0 0 0 0 0 0 0 0 0 0 0 0 0 0 0 0 0 0 0 0 0 0 0 0 0 0 0 0 40 41 54 63 69 145 145 145 125 126 127 182 127 128 204 43 44 0 0 0 0 
0 0 0 0 0 0 0 0 0 0 0 0 0 0 0 0 0 0 0 0 0 0 0 0 0 0 0 0 0 40 41 116 75 89 145 145 145 145 145 145 145 145 145 145 43 44 0 0 0 0 
0 0 0 0 0 0 0 0 0 0 0 0 0 0 0 0 0 0 0 0 0 0 0 0 0 0 0 0 0 40 41 116 130 129 145 145 145 145 145 145 145 145 145 145 43 44 0 0 0 0 
0 0 0 0 0 0 0 1 198 198 198 198 198 198 198 198 198 198 198 198 198 198 198 198 198 198 198 198 198 198 199 136 137 86 86 86 86 86 86 86 62 62 62 62 63 44 0 0 0 0 
0 0 0 0 0 0 20 21 218 218 218 218 218 218 218 218 218 218 218 218 218 218 218 218 218 218 218 218 218 218 42 145 22 22 22 22 22 22 22 23 75 83 83 83 83 0 0 0 0 0 
0 0 0 0 0 0 40 41 42 155 42 42 161 161 161 161 42 42 42 42 161 161 161 161 42 42 161 42 163 42 163 42 42 42 42 42 161 42 134 43 95 102 102 102 103 0 0 0 0 0 
0 0 0 0 0 0 40 41 42 42 161 161 154 42 155 161 161 161 161 161 161 42 42 134 42 161 161 42 42 134 42 155 42 163 163 155 134 161 42 43 115 122 122 122 123 0 0 0 0 0 
0 0 0 0 0 0 40 41 42 42 161 42 134 42 163 163 143 163 42 42 42 42 42 42 42 42 42 161 161 42 163 134 42 42 163 155 42 161 42 43 44 0 0 0 0 0 0 0 0 0 
0 0 0 0 0 0 40 41 42 161 143 163 163 143 42 42 42 42 163 42 42 154 42 163 42 154 42 42 161 161 42 42 42 134 42 42 42 161 134 43 44 0 0 0 0 0 0 0 0 0 
0 0 0 0 0 0 40 41 42 161 161 154 143 163 163 42 154 42 161 143 42 42 42 42 42 42 42 42 42 161 134 42 42 42 42 134 161 161 42 43 44 0 0 0 0 0 0 0 0 0 
0 0 0 0 0 0 40 41 161 161 42 163 163 134 42 163 161 161 163 163 163 42 134 42 163 42 134 42 42 42 155 42 155 42 163 42 42 42 161 43 44 0 0 0 0 0 0 0 0 0 
0 0 0 0 0 0 40 41 42 161 161 161 42 161 161 161 42 155 42 42 42 42 42 42 141 143 42 154 42 163 143 42 163 163 163 161 155 161 134 43 44 0 0 0 0 0 0 0 0 0 
0 0 0 0 0 0 40 41 42 134 42 42 42 42 42 42 42 42 42 42 161 42 155 42 42 141 163 42 42 163 42 42 42 42 134 42 161 42 42 43 44 0 0 0 0 0 0 0 0 0 
0 0 0 0 0 0 40 41 42 42 54 50 55 55 55 55 55 55 55 55 55 55 51 51 51 51 51 51 51 51 51 51 51 51 51 51 51 50 50 63 64 0 0 0 0 0 0 0 0 0 
0 0 0 0 0 0 40 41 42 42 74 75 70 70 70 70 70 70 70 70 70 70 71 71 71 71 71 71 71 71 71 71 71 71 71 71 71 81 82 83 84 0 0 0 0 0 0 0 0 0 
0 0 0 0 0 0 40 41 42 42 94 95 90 90 90 90 90 90 90 90 90 90 91 91 91 91 91 91 91 91 91 91 91 91 91 91 91 81 102 103 104 0 0 0 0 0 0 0 0 0 
0 0 0 0 0 0 80 61 62 62 63 115 110 110 110 110 110 110 110 110 110 110 111 111 111 111 111 111 111 111 111 111 111 111 111 111 111 121 122 123 0 0 0 0 0 0 0 0 0 0 
0 0 0 0 0 0 100 101 102 102 103 0 0 0 0 0 0 0 0 0 0 0 0 0 0 0 0 0 0 0 0 0 0 0 0 0 0 0 0 0 0 0 0 0 0 0 0 0 0 0 
