381 381 381 381 381 381 381 381 381 381 381 381 381 381 381 381 381 381 381 381 381 381 381 381 381 381 381 381 381 381 381 381 381 381 381 381 381 381 381 381 426 427 427 427 427 427 427 427 427 428 
381 381 381 381 381 381 381 381 381 381 381 381 381 381 381 381 381 381 381 381 381 381 381 381 381 381 381 381 381 381 381 381 381 381 381 381 381 381 381 381 446 321 321 423 424 424 424 425 321 448 
381 381 426 427 427 427 427 427 427 427 427 427 427 428 381 381 381 381 381 381 381 381 381 381 381 381 381 381 381 381 381 381 381 381 381 381 381 381 381 381 446 321 321 443 321 321 321 445 321 448 
381 381 446 423 424 424 424 424 424 424 424 424 425 448 381 381 381 381 381 381 426 427 427 427 427 427 427 427 427 427 427 427 427 427 427 427 427 428 381 381 446 423 424 374 321 321 395 465 321 448 
381 381 446 443 321 321 321 321 321 321 308 321 445 448 381 381 381 381 381 381 446 423 424 424 425 423 424 424 424 424 424 424 424 424 424 424 425 448 381 381 446 443 321 324 321 321 445 321 397 468 
381 381 446 443 321 321 321 321 321 321 328 395 465 448 381 381 381 381 381 381 446 443 321 321 445 443 321 321 321 321 321 328 321 321 321 321 445 448 381 381 446 463 464 464 464 464 465 390 468 381 
381 381 446 443 321 321 321 321 321 395 464 465 321 448 426 427 427 427 428 381 446 443 321 321 445 463 464 464 464 464 464 464 464 464 464 464 465 448 381 381 446 321 321 321 321 397 464 388 400 401 
381 381 446 463 464 464 464 464 464 465 321 397 467 468 446 321 321 321 448 381 446 443 321 321 445 321 321 321 321 321 321 321 321 321 321 321 321 448 381 381 446 321 321 321 321 448 381 382 328 321 
381 381 466 467 467 467 467 392 321 321 321 448 381 381 446 321 321 321 448 381 446 463 464 464 465 321 321 321 321 321 321 321 321 321 321 321 308 448 381 381 446 321 321 321 321 448 401 402 308 321 
381 381 381 381 381 381 381 446 321 321 321 377 427 427 376 321 321 321 448 381 446 321 321 321 321 321 423 424 424 424 424 424 425 321 321 321 328 448 381 381 446 321 321 321 321 448 362 321 328 321 
381 381 381 381 381 381 381 446 321 321 321 321 321 321 321 321 308 321 448 381 446 321 321 321 321 321 443 321 321 321 321 321 445 321 321 321 321 448 381 381 446 321 321 321 321 448 382 321 321 389 
381 381 381 381 381 381 381 446 321 321 321 321 321 321 321 321 328 321 448 381 446 321 321 321 321 321 443 321 321 321 321 321 445 321 321 321 321 448 381 381 446 321 321 321 321 448 381 362 321 380 
381 381 381 381 381 381 381 446 321 321 321 321 321 321 321 321 308 321 448 381 446 321 321 321 321 321 443 321 321 321 321 321 445 321 321 321 321 448 381 381 446 321 321 321 321 448 381 381 361 381 
381 381 381 381 381 381 381 446 321 321 321 397 396 321 321 386 321 321 448 381 446 321 321 321 321 321 443 321 321 321 321 321 445 321 321 321 321 377 427 427 376 321 321 321 321 377 427 427 427 428 
381 381 381 381 381 381 381 446 308 321 321 448 446 321 321 321 321 321 448 381 446 321 321 321 321 321 443 321 321 321 321 321 308 321 321 321 321 321 321 321 321 321 423 424 424 424 424 424 425 448 
381 381 381 381 381 381 381 446 321 321 321 448 466 467 467 467 467 464 468 381 446 321 321 321 321 321 443 321 321 321 321 321 328 321 321 321 321 321 321 321 321 321 443 321 321 321 321 321 445 448 
381 426 427 427 427 427 427 376 321 321 321 377 427 427 427 427 427 427 427 427 376 321 321 321 321 321 443 321 321 321 321 321 321 321 308 321 321 321 321 321 321 321 443 321 321 324 324 324 445 448 
381 446 423 424 424 424 424 425 321 321 321 321 308 321 321 321 321 321 321 321 321 321 321 321 321 321 443 321 321 321 321 321 321 321 321 321 321 348 321 321 321 321 463 464 464 394 324 324 445 448 
381 446 443 321 321 321 321 445 321 321 321 321 328 321 321 321 321 321 321 321 321 321 321 321 321 321 463 464 464 464 388 389 390 464 464 464 464 464 464 464 371 464 464 464 394 443 321 321 445 448 
381 446 443 321 321 321 321 445 321 321 321 321 321 321 321 321 321 321 321 321 321 321 321 321 321 321 321 321 321 321 321 321 321 321 321 321 321 321 321 308 321 321 321 321 443 443 321 321 445 448 
381 446 443 321 321 321 321 445 321 321 321 321 321 321 321 321 321 321 321 321 321 321 321 321 321 321 321 321 321 321 321 321 321 321 395 464 464 464 464 464 464 464 394 321 443 443 321 321 445 448 
381 446 443 321 321 321 395 465 321 321 321 321 321 321 321 321 321 321 321 321 321 308 328 321 321 321 321 321 321 321 321 321 321 321 445 321 360 361 361 361 361 362 443 321 443 463 464 464 465 448 
381 446 443 321 321 321 445 423 424 424 424 424 424 424 424 424 424 424 424 424 425 321 308 321 321 321 321 321 321 321 321 321 321 321 375 425 400 401 401 401 401 402 443 321 443 321 321 321 321 448 
381 446 443 321 321 321 445 443 321 321 321 321 321 321 321 321 321 321 321 321 445 348 328 321 321 321 321 321 321 321 321 321 321 321 321 375 424 424 424 424 425 321 443 321 443 321 321 321 321 448 
381 446 443 321 321 321 445 443 321 321 321 321 321 321 321 321 321 321 321 321 445 321 387 321 321 321 321 321 321 321 321 321 321 321 321 321 321 321 321 321 445 321 443 321 443 308 321 321 321 448 
381 446 443 321 321 321 445 443 321 321 321 321 321 321 321 321 321 321 321 321 445 321 386 321 321 321 321 395 464 464 464 464 464 464 464 464 464 464 392 321 445 321 443 321 443 328 321 321 321 448 
381 446 443 321 321 321 445 443 321 321 321 397 464 464 464 464 396 321 321 321 445 321 321 321 321 321 321 445 321 321 321 306 344 344 344 344 307 321 443 321 375 424 374 321 443 321 321 321 321 448 
381 446 443 321 321 321 445 443 321 321 321 445 321 321 321 321 463 388 321 321 445 321 321 321 321 321 321 445 386 387 321 325 309 309 309 309 323 321 443 321 321 327 321 321 443 321 321 321 321 448 
381 446 443 321 321 321 445 443 321 321 321 445 311 312 312 312 313 321 321 321 375 424 424 425 321 321 321 445 387 321 367 325 350 329 350 309 343 321 443 321 321 321 321 321 443 321 321 321 321 448 
381 446 443 321 321 321 445 443 321 321 321 445 331 332 332 332 333 321 321 321 321 321 321 445 321 321 321 445 321 321 348 326 304 304 304 304 327 327 443 321 321 321 321 321 443 321 321 321 321 448 
381 446 443 321 321 321 445 443 321 321 321 445 331 332 439 332 398 312 313 321 321 321 321 445 360 361 362 445 321 386 321 321 321 423 424 424 424 424 374 321 321 321 321 321 443 321 321 321 321 448 
381 446 443 321 321 321 445 374 321 321 321 445 331 332 419 378 379 419 333 321 321 321 321 445 380 381 382 375 321 387 308 321 321 407 321 321 321 321 321 321 308 321 321 321 443 321 321 321 321 448 
381 446 443 321 321 321 445 321 321 321 321 445 331 439 419 398 399 332 333 321 321 321 321 445 400 401 402 321 321 328 406 344 344 307 321 366 321 328 306 344 387 424 424 425 443 321 321 321 321 448 
381 446 443 321 321 321 375 424 424 424 425 445 331 378 379 332 419 332 333 321 321 321 321 445 321 321 321 321 321 306 345 309 309 343 344 344 344 344 345 309 323 321 321 445 443 321 321 321 321 448 
381 446 443 321 397 396 321 321 321 321 445 445 331 398 399 439 332 438 333 321 321 321 321 445 324 321 321 348 321 325 303 304 305 309 309 309 309 309 309 303 327 321 321 445 443 321 321 321 321 448 
381 446 443 321 448 466 467 396 321 321 445 445 331 419 418 352 352 352 353 321 321 321 321 445 321 321 321 324 321 325 323 324 325 309 309 309 309 309 310 323 328 321 321 445 443 321 321 321 321 448 
381 446 443 321 377 427 427 376 321 321 445 445 351 352 353 321 321 321 321 321 321 321 321 445 321 321 321 324 324 325 343 344 345 309 309 309 309 329 350 323 321 348 321 445 443 321 321 321 321 448 
381 446 443 321 321 321 321 321 395 464 465 445 321 321 321 321 321 321 321 321 321 321 321 445 321 324 321 324 306 307 304 304 304 304 304 304 304 304 304 346 307 321 321 445 443 321 321 308 321 448 
381 446 463 464 464 464 467 467 465 321 386 445 423 424 424 424 425 321 321 321 321 321 321 445 321 443 324 324 326 327 324 324 324 324 324 324 324 324 324 326 327 328 321 445 443 321 321 328 393 468 
381 466 467 467 467 396 321 321 321 321 321 445 443 321 321 321 445 321 393 388 369 370 464 465 321 463 464 464 464 464 464 464 464 464 464 464 371 464 464 464 464 464 464 465 463 388 389 370 468 381 
381 381 381 381 381 446 321 321 321 321 321 445 463 464 464 464 465 321 445 321 321 321 321 348 387 321 321 321 321 321 321 321 321 321 321 321 321 321 321 321 321 328 308 311 312 312 312 319 381 381 
381 381 381 381 381 446 321 321 321 321 321 445 321 321 423 424 424 425 445 321 321 321 321 321 367 321 321 321 321 321 321 321 321 321 321 321 321 321 321 321 321 311 312 399 332 419 332 339 381 381 
381 381 381 381 381 446 321 321 321 321 321 445 321 321 443 321 321 445 445 321 321 321 321 386 321 321 321 321 321 321 321 321 321 321 321 321 321 321 321 321 321 331 438 332 332 438 439 339 381 381 
381 381 381 381 381 446 321 321 321 321 321 445 370 394 443 321 321 445 445 321 321 321 366 321 321 321 321 321 321 321 321 321 321 321 321 321 321 321 321 321 321 331 332 418 439 332 332 398 318 319 
381 426 427 427 427 376 308 321 321 321 321 445 321 443 443 321 321 445 375 424 424 424 424 424 424 424 424 424 424 424 424 424 424 424 424 424 424 425 311 312 312 399 332 378 379 439 332 419 332 339 
381 446 321 321 321 321 328 321 321 321 321 445 321 443 443 321 321 445 321 321 321 321 321 321 321 321 321 321 321 321 321 321 321 321 321 321 321 445 331 332 332 332 419 398 399 332 332 332 332 333 
381 446 321 321 321 321 321 321 321 321 321 445 321 443 463 464 371 465 321 321 321 321 321 321 321 321 321 321 321 321 321 321 321 321 321 321 321 445 331 418 419 332 439 332 439 419 438 439 332 333 
381 446 321 321 321 321 321 321 321 321 321 445 321 443 321 308 321 321 321 321 321 321 321 321 321 321 321 321 321 321 321 321 321 321 321 321 390 445 331 332 438 439 438 419 438 332 332 332 378 359 
381 446 321 321 321 321 321 321 321 321 321 445 321 443 321 328 321 321 321 321 321 321 321 321 321 321 321 321 321 321 321 321 321 321 321 321 321 445 331 332 418 439 332 332 419 332 419 332 339 381 
381 466 467 467 467 467 467 467 467 467 467 465 406 463 461 461 461 461 461 461 461 461 461 461 461 461 461 461 461 461 461 461 461 461 461 461 461 465 351 358 358 358 358 358 358 358 358 358 359 381 
