440 321 321 443 321 321 321 321 321 321 445 321 321 442 0 0 0 0 0 0 0 0 0 0 0 0 0 0 0 0 0 0 0 0 0 0 0 0 0 0 0 0 0 0 0 0 0 0 0 0 0 0 0 0 0 
440 321 321 443 321 321 321 321 321 321 445 321 321 442 0 0 0 0 0 0 0 0 0 0 0 0 0 0 0 0 0 0 0 0 0 0 0 0 0 0 0 0 0 0 0 0 0 0 0 0 0 0 0 0 0 
440 321 321 443 321 321 321 321 321 321 445 321 321 442 0 0 0 0 0 0 0 0 0 0 0 0 0 0 0 0 0 0 0 0 0 0 0 0 0 0 0 0 0 0 0 0 0 0 0 0 0 0 0 0 0 
440 321 321 443 321 321 321 321 321 321 445 321 321 442 0 0 0 0 0 0 0 0 0 0 0 0 0 0 0 0 0 432 433 433 433 433 434 0 0 0 0 0 0 0 0 0 0 0 0 0 0 0 0 0 0 
440 328 348 443 321 308 321 348 395 464 465 393 461 462 0 0 0 0 0 0 0 0 0 0 0 0 0 0 0 0 432 498 309 310 309 309 499 434 0 0 0 0 0 432 433 433 433 433 433 434 0 0 0 0 0 
440 321 321 443 321 321 395 464 465 308 321 442 335 335 0 0 0 0 0 0 0 0 0 0 0 0 0 0 0 432 498 309 309 309 310 309 309 499 434 0 0 0 0 452 430 430 431 350 349 454 0 0 0 0 0 
460 461 392 463 464 464 465 393 461 461 461 462 0 335 0 0 0 0 0 0 0 0 0 0 0 0 0 0 432 498 309 314 315 315 315 316 309 309 454 0 0 0 420 372 308 324 451 310 309 454 0 0 0 0 0 
0 0 452 343 348 321 393 462 0 0 0 0 0 335 0 0 0 0 0 0 0 0 0 0 0 0 0 0 452 309 309 334 438 332 438 336 309 310 499 421 421 421 372 324 324 397 471 363 365 454 0 0 0 0 0 
0 0 452 303 321 308 442 335 0 0 0 0 0 0 0 0 0 0 0 0 432 433 433 433 433 433 433 433 498 309 314 399 418 419 439 336 329 309 449 321 321 328 308 308 348 451 363 384 405 454 0 0 0 0 0 
0 0 452 323 348 321 442 335 0 0 0 0 0 0 0 0 0 0 0 432 498 309 329 309 310 309 350 309 309 309 334 419 332 418 418 336 363 365 469 371 396 321 321 348 308 451 403 405 309 454 0 0 0 0 0 
0 0 452 343 324 321 442 335 0 0 0 0 0 0 0 0 0 0 0 452 309 309 435 436 436 436 436 437 330 309 334 418 439 438 378 356 383 384 365 309 469 470 396 328 397 471 350 309 519 474 0 0 0 0 0 
0 0 440 345 343 324 442 335 0 0 0 0 0 0 0 0 0 432 433 498 309 435 458 309 435 436 437 457 309 314 399 378 355 355 356 309 383 384 384 365 309 309 469 470 471 349 309 519 474 0 0 0 0 0 0 
335 432 498 309 349 343 373 421 421 433 434 0 0 0 0 0 432 498 309 330 309 455 309 349 455 310 457 457 309 354 355 356 309 309 309 363 384 384 384 384 365 309 309 309 309 310 309 454 0 0 0 0 0 0 0 
432 498 303 305 309 309 323 308 345 309 499 433 433 434 0 0 452 309 309 309 309 455 309 350 475 476 477 457 309 309 309 309 363 364 364 384 384 384 384 384 384 365 309 329 309 309 519 474 0 0 0 0 0 0 0 
452 309 343 345 309 309 343 345 309 429 430 430 431 499 434 0 472 518 329 310 309 475 476 478 309 329 309 457 350 309 363 364 384 384 384 384 384 384 384 384 300 301 305 329 309 309 454 335 335 335 0 0 0 0 0 
452 309 350 309 363 365 349 309 310 449 348 308 451 349 499 434 335 472 518 309 309 309 309 455 309 309 479 477 309 363 384 384 384 384 384 384 402 301 301 301 423 424 425 305 309 309 454 335 335 335 0 0 0 0 0 
452 309 329 309 383 384 365 309 363 466 396 328 451 329 309 499 434 335 472 473 518 309 330 475 408 410 477 309 309 403 384 384 384 300 301 301 308 308 321 423 374 424 445 325 309 309 499 433 433 434 0 0 0 0 0 
452 309 350 309 383 384 384 364 384 384 446 348 451 309 310 309 499 335 335 0 472 518 309 309 309 309 309 330 309 309 383 384 300 321 328 324 324 321 423 374 321 308 445 321 305 309 309 309 309 454 0 0 0 0 0 
452 309 309 363 381 300 301 301 302 384 466 371 468 365 309 310 309 499 434 0 0 0 518 309 309 350 309 309 309 363 384 384 340 341 341 321 321 328 443 321 328 321 445 328 325 329 309 329 310 454 0 0 0 0 0 
472 473 518 403 381 320 328 308 321 302 384 384 384 364 364 365 309 309 454 0 0 0 472 473 473 473 518 309 309 403 384 384 384 384 384 340 341 321 463 464 464 464 465 321 325 309 309 309 519 474 0 0 0 0 0 
0 0 452 309 403 340 341 328 321 308 301 302 384 384 404 405 309 519 474 0 0 0 0 0 0 0 472 518 310 309 403 384 384 384 384 384 384 340 341 321 321 321 321 321 325 309 349 309 454 0 0 0 0 0 0 
0 0 452 330 309 403 404 340 341 341 341 342 384 405 329 309 519 474 0 0 0 0 0 0 0 0 0 452 309 309 329 403 384 384 384 384 384 384 384 340 341 321 328 328 325 309 309 349 499 433 434 0 0 0 0 
0 0 452 309 350 309 330 403 404 404 404 404 405 309 309 349 454 335 335 335 335 335 0 0 0 0 0 472 518 309 309 309 403 404 404 384 384 384 384 384 384 340 341 321 324 305 309 309 309 309 454 0 0 0 0 
0 0 472 473 518 309 309 309 309 349 309 309 309 329 309 519 474 0 0 0 0 0 0 0 0 0 0 0 472 518 309 309 349 350 309 403 384 384 384 384 404 384 384 320 321 311 315 316 309 309 454 0 0 0 0 
0 0 0 0 472 473 518 329 309 519 473 473 473 473 473 474 0 0 0 0 0 0 0 0 0 0 0 0 0 0 518 309 350 349 310 309 403 404 404 405 309 403 384 340 341 331 332 398 316 349 454 0 0 0 0 
0 0 0 0 0 0 452 350 519 474 0 0 0 0 0 432 433 433 433 433 433 433 434 0 0 0 0 0 0 0 472 473 473 518 309 309 329 309 309 309 350 309 403 384 317 417 379 378 356 309 499 0 0 0 0 
0 0 0 0 0 0 452 349 454 0 0 0 0 0 432 498 329 309 309 309 309 309 499 433 433 433 433 434 0 0 0 0 0 472 518 309 309 309 519 473 518 309 309 403 357 356 354 356 349 309 349 454 0 0 0 
0 0 0 0 0 0 452 309 454 0 0 0 0 0 452 309 309 309 314 315 316 309 309 309 309 329 309 454 0 0 0 0 0 0 472 473 473 473 474 0 472 518 350 309 519 476 518 309 350 519 473 474 0 0 0 
0 0 0 0 0 0 452 350 454 0 0 0 0 432 498 309 310 309 334 418 398 316 309 350 309 309 309 499 434 0 0 0 0 0 0 0 0 0 0 0 0 452 309 349 499 434 472 473 473 474 0 0 0 0 0 
0 0 0 0 0 432 498 309 454 0 0 0 0 452 309 329 309 314 399 332 419 398 315 315 316 309 309 429 454 0 0 0 0 0 0 0 0 0 0 0 0 452 309 309 330 454 0 413 413 0 0 0 0 0 0 
0 0 0 0 0 452 309 349 454 0 0 0 0 452 309 309 309 334 439 438 439 378 355 355 356 309 330 519 474 0 0 0 0 0 0 0 0 0 0 0 0 472 518 329 310 454 0 413 413 0 0 0 0 0 0 
0 0 0 0 0 452 329 309 454 0 0 0 0 452 309 330 309 334 438 419 378 356 309 309 309 350 429 454 0 0 0 0 0 0 0 0 0 0 0 0 0 432 498 309 309 454 0 0 0 0 0 0 0 0 0 
0 0 0 0 0 452 350 309 454 0 0 0 0 452 330 309 309 354 379 378 356 309 350 349 309 309 519 474 0 0 0 0 0 0 0 0 432 433 433 433 433 498 309 309 309 499 434 0 0 0 0 0 0 0 0 
0 0 0 0 432 498 309 349 454 0 0 0 0 452 309 349 350 309 334 336 309 309 330 309 309 519 474 0 0 0 0 0 0 0 0 0 452 309 330 309 329 309 309 350 309 309 499 434 0 0 0 0 0 0 0 
0 0 0 432 498 309 309 519 474 0 0 0 432 498 309 309 309 314 417 356 309 309 309 309 519 474 0 0 0 0 0 0 0 0 0 0 452 329 330 309 350 309 303 305 309 350 309 499 433 434 0 0 0 0 0 
0 0 0 452 350 310 309 454 0 0 0 0 452 309 309 309 314 399 336 309 309 309 309 519 474 432 433 433 433 433 433 433 433 433 434 432 498 309 309 309 303 304 324 328 304 305 309 309 310 454 0 0 0 0 0 
0 0 0 452 329 330 349 454 0 0 0 0 452 309 350 309 354 379 398 315 316 309 309 499 433 498 309 309 309 329 309 309 309 309 499 498 309 309 309 303 308 324 324 328 324 345 350 309 519 474 0 0 0 0 0 
0 0 0 452 329 309 519 474 453 453 0 0 452 329 309 309 309 354 355 379 398 315 316 309 309 309 309 435 436 436 436 437 309 310 309 309 309 349 309 323 328 324 348 324 345 349 309 519 474 0 0 0 0 0 0 
0 0 0 452 350 309 454 0 0 453 453 453 452 309 329 330 309 310 309 354 355 355 356 309 309 309 309 455 309 330 309 457 309 519 473 473 518 309 303 324 423 424 424 425 305 309 329 454 0 0 0 0 0 0 0 
0 0 0 452 309 349 454 0 432 433 433 453 472 473 473 518 309 309 310 309 309 309 309 349 309 310 429 458 329 329 309 457 519 474 0 432 498 303 324 324 443 324 324 448 362 305 309 499 434 0 0 0 0 0 0 
0 0 432 498 309 309 454 432 498 309 329 499 433 434 0 472 473 473 473 473 518 309 309 309 350 309 455 309 309 309 479 477 454 0 0 452 309 323 342 361 446 324 324 377 427 425 305 330 499 434 0 0 0 0 0 
0 0 452 309 310 309 499 498 309 330 309 309 309 499 434 0 0 0 0 432 498 309 309 309 309 309 455 349 309 479 477 519 474 0 0 452 330 323 380 426 376 324 324 324 324 445 324 305 309 454 0 0 0 0 0 
0 432 498 309 309 309 309 310 309 309 314 315 316 309 499 434 0 0 0 452 309 309 329 330 309 435 458 309 309 457 309 454 0 0 0 452 309 323 400 376 324 324 311 312 313 445 324 325 309 454 0 0 0 0 0 
432 498 429 430 431 309 309 309 309 309 334 419 336 309 309 454 0 0 0 472 518 309 309 309 309 455 309 310 479 477 309 454 0 0 0 452 303 324 443 324 324 360 337 438 333 445 324 325 309 454 0 0 0 0 0 
452 309 449 348 451 309 310 350 309 309 354 355 356 309 309 454 0 0 0 0 472 518 309 330 309 475 478 309 457 309 519 474 0 0 0 452 323 324 443 324 324 380 357 358 353 445 324 325 330 454 0 0 0 0 0 
452 310 469 391 471 309 309 350 309 309 309 309 309 330 309 454 0 0 0 0 0 472 518 309 349 350 475 411 477 519 474 0 0 0 0 452 343 344 463 392 324 400 401 402 395 465 324 345 309 454 0 0 0 0 0 
472 518 309 309 309 309 309 330 309 310 350 309 309 330 309 499 433 433 433 434 0 413 472 518 309 309 309 309 309 454 0 0 0 0 0 472 518 309 343 463 388 390 464 464 465 324 345 350 519 474 0 0 0 0 0 
0 472 518 309 349 309 429 430 431 309 329 330 309 309 349 309 309 350 309 454 0 0 0 472 473 518 309 519 473 474 0 0 0 0 0 413 472 518 309 343 344 324 324 324 324 325 349 519 474 0 0 0 0 0 0 
0 0 452 309 309 309 449 348 451 350 309 350 309 519 473 473 473 518 309 454 0 0 0 0 0 452 349 454 0 0 0 0 0 0 0 0 0 472 518 350 349 343 344 344 344 345 519 474 0 0 0 0 0 0 0 
0 0 452 349 309 329 469 470 471 309 309 309 309 454 0 0 0 452 329 499 433 433 433 433 433 498 309 454 0 0 0 0 0 0 0 0 0 0 472 473 473 473 473 473 473 473 474 0 0 0 0 0 0 0 0 
0 0 452 309 309 309 350 309 350 519 519 519 473 474 0 0 0 452 309 309 309 350 309 330 309 310 309 454 0 0 0 0 0 0 0 0 0 0 0 0 335 335 335 0 0 0 0 0 0 0 0 0 0 0 0 
0 0 472 473 473 518 309 309 309 454 0 0 0 0 0 0 0 472 473 473 473 473 473 473 473 473 473 474 0 0 0 0 0 0 0 0 0 0 0 335 335 0 0 0 0 0 0 0 0 0 0 0 0 0 0 
0 0 0 0 0 472 473 473 473 474 0 0 0 0 0 0 0 0 0 0 0 0 0 0 0 0 0 0 0 0 0 0 0 0 0 0 0 0 0 0 0 0 0 0 0 0 0 0 0 0 0 0 0 0 0 
0 0 0 0 0 0 0 0 0 0 0 0 0 0 0 0 0 0 0 0 0 0 0 0 0 0 0 0 0 0 0 0 0 0 0 0 0 0 0 0 0 0 0 0 0 0 0 0 0 0 0 0 0 0 0 
0 0 0 0 0 0 0 0 0 0 0 0 0 0 0 0 0 0 0 0 0 0 0 0 0 0 0 0 0 0 0 0 0 0 0 0 0 0 0 0 0 0 0 0 0 0 0 0 0 0 0 0 0 0 0 
