572 585 572 572 572 572 572 585 553 584 553 553 553 553 574 584 554 548 0 0 0 0 550 602 544 548 0 0 0 0 0 0 0 550 554 554 584 553 554 554 584 554 554 554 584 572 585 572 572 572 
572 572 572 572 585 572 553 574 554 553 564 554 564 553 553 554 528 587 0 0 0 0 550 553 553 548 0 0 0 0 0 0 0 586 530 554 554 554 554 554 585 554 554 554 554 554 554 585 572 585 
572 585 572 572 572 553 553 574 574 564 553 553 553 553 554 554 548 0 0 0 0 0 550 560 553 548 549 0 0 0 0 0 0 0 586 530 554 554 584 554 554 564 554 584 554 554 585 554 584 572 
572 572 572 572 554 553 564 554 574 553 553 553 553 574 528 529 587 0 0 0 0 566 570 560 528 587 549 0 0 0 0 0 0 0 0 586 530 554 584 554 554 554 554 554 554 564 585 554 554 554 
572 585 572 553 554 564 554 574 574 553 553 584 574 554 548 0 0 0 0 0 0 550 543 554 548 549 0 0 566 569 569 567 0 0 0 0 586 530 554 554 554 584 554 584 554 554 554 554 554 554 
553 585 553 574 554 554 574 574 574 584 574 574 574 554 548 0 0 0 0 0 0 550 563 560 548 0 0 0 550 554 528 587 0 0 0 0 0 586 530 554 554 554 554 553 553 553 564 554 554 584 
553 553 553 564 554 584 553 584 553 553 564 574 554 528 587 0 0 0 0 0 566 570 583 561 548 0 0 0 586 529 587 0 0 0 0 0 0 0 586 529 529 530 554 554 585 554 554 554 554 554 
553 553 554 554 554 553 553 574 574 574 574 554 528 587 0 0 0 0 0 0 550 572 580 580 568 567 0 0 0 0 0 0 0 0 0 0 0 0 0 0 0 586 529 530 554 564 554 554 554 585 
584 553 554 574 574 574 584 574 574 554 528 529 587 0 0 0 0 0 0 566 570 572 541 554 554 568 569 569 569 569 569 569 567 0 0 0 0 0 0 0 0 0 0 550 554 554 554 584 554 554 
554 554 564 574 574 574 574 554 554 528 587 0 0 0 0 566 569 569 569 570 585 572 554 554 603 554 554 554 554 603 554 553 568 569 567 0 0 0 0 0 0 0 0 586 529 530 554 554 554 554 
554 564 574 574 554 584 554 528 529 587 0 0 0 0 0 550 573 574 573 553 572 553 554 554 554 554 554 554 554 603 554 554 554 574 548 0 0 0 0 0 0 0 0 0 0 550 554 554 564 553 
554 564 554 554 528 529 529 587 0 0 0 0 0 0 0 550 554 531 532 532 532 532 532 532 532 533 534 534 534 534 534 534 535 574 548 0 0 0 0 0 0 0 0 0 0 586 529 529 529 529 
554 554 554 528 587 0 0 0 0 0 0 0 0 0 0 550 554 551 572 572 541 585 593 572 572 572 540 573 552 573 574 574 555 574 568 569 567 0 0 0 0 0 0 0 0 0 0 0 0 0 
574 528 529 587 0 0 0 0 0 0 0 0 0 0 566 570 554 551 572 541 572 552 593 573 593 541 572 573 553 553 553 574 555 554 554 553 548 0 0 0 0 566 569 567 0 0 0 0 0 0 
528 587 0 0 0 0 0 0 0 0 0 0 566 569 570 553 560 551 592 592 592 592 592 592 594 593 594 594 594 594 594 594 555 554 572 572 548 0 0 0 0 550 554 548 0 0 0 0 0 0 
587 0 0 0 0 0 0 0 0 0 0 0 550 553 540 541 554 611 612 612 612 602 612 614 614 613 614 614 614 614 602 614 615 553 553 572 568 567 0 0 0 586 529 587 0 0 0 0 0 0 
0 0 0 0 0 0 0 0 0 0 0 0 550 553 621 553 553 553 573 572 604 622 604 544 582 554 542 544 554 554 553 553 553 553 625 572 554 548 0 0 0 0 0 0 0 0 0 0 0 0 
0 0 0 0 0 0 0 0 0 0 0 0 550 553 553 574 605 574 554 625 624 622 624 603 543 553 542 553 572 553 553 553 574 553 572 528 529 587 0 0 0 0 0 0 0 0 0 0 0 0 
0 0 0 0 0 0 0 0 0 0 0 0 550 553 553 574 554 553 574 553 572 572 603 553 542 554 542 553 560 541 554 554 553 572 572 548 0 0 0 0 0 0 0 0 0 0 0 0 0 0 
0 0 0 0 0 0 0 0 0 0 0 0 550 553 553 553 553 574 574 585 572 572 572 605 542 554 563 521 523 521 524 524 521 525 573 548 0 0 0 0 0 0 0 0 0 0 0 0 0 0 
0 0 0 0 0 0 0 0 0 0 0 0 586 529 529 529 530 553 553 553 553 585 572 572 542 553 553 553 560 540 572 572 572 554 553 548 0 0 566 569 567 0 0 0 0 0 0 0 0 0 
0 0 0 0 0 0 0 0 0 0 0 0 0 0 0 0 586 529 529 530 553 553 553 553 542 574 563 521 524 522 525 526 527 572 554 548 0 566 570 553 568 567 0 0 0 0 0 0 0 0 
0 0 0 0 0 0 0 0 0 0 0 0 0 0 0 0 0 0 0 586 529 529 529 530 583 574 582 574 572 542 572 546 547 553 528 587 0 550 553 553 553 548 0 0 0 0 0 0 0 0 
0 0 0 0 0 0 566 569 569 569 567 0 0 0 0 0 0 0 0 0 0 0 0 586 530 554 572 572 572 542 572 585 585 572 548 0 0 550 553 553 528 587 0 0 0 0 0 0 0 0 
0 0 0 0 566 569 570 544 554 554 568 567 0 0 0 0 0 0 0 0 0 0 0 0 550 554 554 572 572 542 572 585 585 528 587 0 0 586 529 529 587 0 0 0 0 0 0 0 0 0 
0 566 567 0 550 554 572 572 554 554 554 588 589 589 589 589 589 589 589 589 589 589 589 589 590 574 554 554 554 582 554 554 554 548 0 0 0 0 0 0 0 0 0 0 0 0 0 0 0 0 
0 586 587 0 586 529 529 530 554 554 554 548 0 0 0 0 0 0 0 0 0 0 0 0 586 529 529 529 529 529 529 529 529 587 0 566 569 569 569 569 569 569 569 567 0 0 0 0 0 0 
0 0 0 0 0 0 0 550 554 528 529 587 0 0 0 0 0 0 0 0 0 0 0 0 0 0 0 0 0 0 0 0 0 566 569 570 554 554 554 554 554 554 603 568 567 0 0 0 0 0 
0 0 0 0 0 0 0 550 554 548 0 0 0 0 566 567 0 0 0 0 0 0 0 0 0 0 0 0 0 0 0 566 569 570 585 554 554 554 554 554 554 554 553 554 568 569 567 0 0 0 
0 0 0 0 0 0 0 550 554 548 0 0 0 0 550 568 567 0 0 0 0 0 0 0 0 0 0 0 0 0 566 570 554 554 554 544 554 554 603 554 554 554 554 554 554 554 568 567 0 0 
0 0 0 0 0 0 0 550 554 548 0 0 0 0 586 530 548 0 0 0 0 0 0 0 0 0 0 0 0 0 550 554 554 572 554 554 554 554 574 574 574 574 574 574 574 554 554 548 0 0 
0 0 0 0 0 0 566 570 554 568 567 0 0 0 0 586 587 0 0 0 0 0 0 0 0 0 0 0 0 0 586 530 554 554 572 572 572 572 574 574 572 572 572 574 574 574 528 587 0 0 
0 0 0 0 0 0 550 554 603 554 548 0 0 0 0 0 0 0 0 0 0 0 0 0 0 0 0 0 0 0 0 586 529 530 554 554 554 572 572 572 572 572 572 572 574 574 548 0 0 0 
0 0 0 0 0 0 550 554 554 554 568 569 569 569 567 0 0 0 0 0 0 0 0 0 0 566 569 569 569 567 0 0 0 586 529 529 529 529 530 574 574 574 574 574 603 574 568 567 0 0 
0 0 0 0 0 0 586 529 530 554 554 554 554 554 568 569 567 0 0 0 0 0 0 0 566 570 554 603 553 548 549 0 0 0 0 0 0 0 586 529 529 529 529 530 574 574 574 568 567 0 
0 0 0 0 0 0 0 0 550 528 529 529 530 554 553 554 588 589 589 589 589 589 589 589 590 573 554 554 554 568 567 0 0 0 0 0 0 0 0 0 0 0 0 586 529 530 574 600 568 569 
0 0 0 0 0 0 0 0 550 568 569 569 570 603 554 554 548 0 0 0 0 0 0 0 550 573 554 572 553 572 548 0 0 0 0 0 0 0 0 0 0 566 569 567 0 586 529 530 601 620 
0 0 0 0 0 0 0 0 586 529 529 529 529 529 529 529 587 566 569 567 0 0 0 0 586 530 554 553 553 553 568 567 0 0 0 0 0 0 0 0 0 550 553 568 569 567 0 586 529 529 
0 0 0 0 0 0 0 0 0 0 0 0 0 0 0 0 0 550 554 568 567 0 0 0 0 586 530 553 553 572 554 568 567 0 0 0 0 0 0 0 0 550 553 554 554 568 567 0 0 0 
0 0 0 0 0 0 0 0 0 0 0 0 0 0 0 0 566 570 554 554 548 0 0 0 0 0 550 572 553 553 572 554 548 0 0 0 0 0 0 0 0 586 529 530 574 574 548 0 0 0 
0 0 0 0 0 0 0 0 566 569 569 569 569 567 0 0 586 530 554 554 548 0 0 0 0 0 550 572 553 572 572 554 548 0 0 0 0 0 0 0 0 0 0 586 529 529 587 0 0 0 
0 0 0 0 0 0 0 566 570 553 574 554 565 568 567 0 0 586 529 529 587 0 0 0 0 0 550 554 554 554 552 554 548 0 0 0 0 0 0 0 0 0 0 0 0 0 0 0 0 0 
0 0 0 0 0 0 0 550 553 620 574 574 574 574 548 0 0 0 0 0 0 0 0 0 0 0 550 554 554 554 572 554 548 0 0 0 0 0 0 0 0 0 0 0 0 0 0 0 0 0 
569 569 567 0 0 0 0 586 529 530 554 574 528 529 587 0 0 0 0 0 0 0 0 0 566 569 570 554 554 554 572 554 548 0 0 0 0 0 0 0 0 0 0 0 0 0 0 0 0 0 
554 554 568 567 0 0 0 0 0 586 529 529 587 0 0 0 0 0 0 0 0 566 569 569 570 554 554 554 554 572 572 528 587 0 0 0 0 0 0 0 0 0 0 0 0 0 566 569 569 569 
554 564 554 548 0 0 0 0 0 0 0 0 0 0 0 0 0 0 0 0 566 570 554 603 554 528 529 529 530 554 528 587 0 0 0 0 0 0 0 0 0 0 0 0 0 566 570 574 574 584 
585 554 554 568 567 0 0 0 0 0 0 0 0 0 0 0 0 0 0 566 570 528 529 529 529 587 566 569 570 528 587 0 0 0 0 0 0 0 0 0 0 0 0 0 566 570 574 584 603 553 
585 585 564 554 568 569 567 0 0 0 0 0 0 0 0 0 0 0 0 550 554 548 0 0 0 566 570 528 529 587 0 0 0 0 0 0 0 0 0 0 566 569 569 569 570 574 574 585 585 553 
572 572 554 554 584 603 568 569 569 569 569 569 569 567 0 0 0 0 0 550 554 548 566 569 569 570 528 587 0 0 0 0 0 0 0 0 566 569 569 569 570 584 553 574 584 603 553 553 572 572 
572 572 572 554 584 585 554 554 564 585 554 584 554 548 0 0 0 0 0 550 554 568 570 573 554 528 587 0 0 0 0 0 566 569 569 569 570 584 603 585 553 574 572 572 585 585 553 572 572 572 
